XXXXXXXXXXXXXXXXXXXXXXXXXXXXXXXXXXXXXXXXXXXXXXXXXXXXXXXXXXX
X @      X   OOOOOOOOO X                                  X
X        X   $$$$$$$$$ X                                  X
X    .   X   OOOOOOOOO X                                  X
X    .   X   $$$$$$$$$ X                                  X
XXXXX.XXXXXXXXXXX.XXXXXX                                  X
X               ...                                       X
X                                                         X
X    E                                                    X
X                                                         X
X                                                         X
X                                                         X
X                                                         X
X                                                         X
X                                                         X
X                                                         X
X                                                         X
X                                                         X
X                                                         X
X                                                         X
X                                                         X
X                                                         X
X                                                         X
X                                                         X
X                                                         X
XXXXXXXXXXXXXXXXXXXXXXXXXXXXXXXXXXXXXXXXXXXXXXXXXXXXXXXXXXX